NO textures/wood.xpm
SO textures/steel.xpm
WE textures/stone.xpm
EA textures/bricks.xpm

F 220,100,0
C 255,0,0

11111
1N001
10101
10001
11111