NO textures/wall/rustymetal.xpm
SO textures/wall/rustywall.xpm
EA textures/wall/rustywall2.xpm
WE textures/wall/wall3.xpm

F 128,128,128
C 26,26,26


111111111
1011B1101
100000001
100000001
100111001
100111001
100000001
100000001
11M1G1111
100001001
100001001
100001001
100001001
100000001
100000001
111111G11
100000001
100000001
1000N0001
111111111
