NO textures/wall/rustymetal.xpm
SO textures/wall/rustywall2.xpm
EA textures/wall/rustywall.xpm
WE textures/wall/wall3.xpm

F      105,105,105
C 42,42,42

1111111111111111111111111
1000000011000000111101001
1000000011000000100001001
1000000011000000100101001
1000000011000000100101001
1000000011000000100101001
1000000011000000100101111
1000000011000000100100001
10000000001100001001001G1
1000000011000000100100101
1000000110000000100100101
10000000B0000000000100101
100000011000000001111M101
1000000011000000000100001
1000000000110000000100001
1111111111111111111100001
1000000000000001111100001
1000000000000001000000011
100000000000000100000001
100000000000000111110111
100000000000000100000111
1000000000000001G1000001
100000000000000101000001
100000000000000101111111
100000000000000100000001
100000000000000100000001
100000000000000100000001
100000000000001100000001
1000000000000001111111G1
111111111000000100000001
111111100100000100000001
111111100010001100000001
1111111G1111111100000001
100000000000000000001111
1000000N0000000000000001
111111100000000000000001
111111111111111111111111