NO textures/wall/rustymetal.xpm
SO textures/wall/rustywall.xpm
EA textures/wall/rustywall2.xpm
WE textures/wall/wall3.xpm

F      105,105,105
C 42,42,42


1111111111
1000000001
1000000001
1111101111
1000000001
1000000001
1000000001
1000N00001
1000000001
1000000001
1000000001
1000000001
1111111111
